..................................................
..................................................
..................................................
..................................................
..................................................
..................................................
..................................................
..................................................
..................................................
..................................................
..................................................
..................................................
..................................................
..................................................
..................................................
..................................................
..................................................
..................................................
..................................................
..................................................
..................................................
..................................................
..................................................
..................................................
..................................................
..................................................
...............###################................
...............#.................#................
...............#........#####....#................
...............#........#...#....#................
...............#........##O##....#................
...............#.................#................
...............##############O#..#................
...............#...O..TTT.#s..#..#................
...............#####......O...#..#................
...............#.s.O...B..#...#..#................
...............#t..#C..B..#F..#..#................
...............#SSS############..#................
...............#####.........F##O#................
...............#..............#...................
...............#.........##O###...................
...............########..#....#...................
...............#SS.ts.O..#....#...................
...............#SS....#..#...C#...................
...............########O##....#...................
.........................#T.BB#...................
.........................######...................
..................................................
..................................................